###################
#FOOOOOOOOOOOOOOOF#
#OOOOO  G   OOOOOO#
#O                #
#OOOOOOOOOOOOOOOOO#
#OOOOOOOOOOOOOFOOO#
#OOMOOO        MOO#
#OO OOO         OO#
#OO OOO####     OO#
#OO OOO####     OO#
#OO OOO####     OO#
#OO OOO####  M  OO#
#OOOOOOOOOOOOOOOOO#
#OOFOOOOOOOOOOOOOO#
#OOOOOOOOOOOOOOOOO#
#O                #
#OOO   OOOOOOFOOOO#
#OOM   OOOOOOOOOOO#
#OOOOOOOOOOOOOOOOF#
###################
