###################
#0OOOOOOOOOOOOOOO0#
#OOOOO  GU  OOOOOO#
#O                #
#OOOOOOOOOOOOOOOOO#
#OOOOOOOOOOOOO0OOO#
#OOMOOO        MOO#
#OO OOO         OO#
#OO OOO####     OO#
#OO OOO####     OO#
#OO OOO####     OO#
#OO OOO####  M  OO#
#OOOOOOOOOOOOOOOOO#
#OO0OOOOOOOOOOOOOO#
#OOOOOOOOOOOOOOOOO#
#O                #
#OOO   OOOOOO0OOOO#
#OOM   OOOOOOOOOOO#
#OOOOOOOOOOOOOOOO0#
###################
